111111111111111111111111
100000000000000000000001
100000000000000000000001
111111100000000000000001
1000000000000000P0000001
1000C0000000000000000001
100000000000000000000001
100000000000000000000001
1000000000000E0000000001
100000000000E00000000001
100000000000000000000001
100000000000000000000001
100000000000000000000001
100000000000000000000001
100000000000000000000001
100000000000000000000001
100000000000000000000001
100000000000000000000001
100000000000000000000001
100000000000000000000001
100000000000000000000001
100000000000000000000001
100000000000000000000001
111111111111111111111111