111111
10E001
10C001
100P01
10P001
111111