111111
10E001
100001
10P001
100001
111111