111111
10E001
100001
10C001
100001
111111