11111111111111111111111111111111111111111111111111111
10000000000000000000000000000000000000000000000000001
100000C000000000000000C000000000000000000000000000001
10000000000000000000000000000000000000000000C00000001
10000000011111111111111111111111000000000000000000001
10000C00010000000000000000000000000000000000000000001
10000000010000000000000000000000000000000000000000001
100C0000010000000000000000000000C00000000000000C00001
10000000010000000C00000000000000000000000000000000001
10000000010000000000000000000000000000000000000000001
10000C00011111111111111111111111111111111110000000001
10000000000000000000000000000000000000000010000000001
10C00000000000000000000000000000000000000010000000001
1000000000000000000000000C000000000000000010000000001
10000000000000000000000000000000000000000010000000001
100000000000000000000000000000000000000000100000C0001
10000000000000000000000000000C00000000000010000000001
100000000000000000P0000000000000000000000010000000001
10000000000000000000000000000000000000000010000000001
11111000000011111111111111111111111111111110000000001
10000000000010000000000000000000000000000000000000001
10000000000010000000E00000000000000000000000000000001
10000000000010011111111111111111111111111111111110001
10000000000000000000000000000000000000000000000000C01
11111111111111111111111111111111111111111111111111111