1111111111111111111111
100P000000000000000001
1111111110000011111111
1000000000000000000001
100C001111111111111111
1000000000000000000001
1111111111100000C00001
1000000000000000000001
1000111111111111111111
100000C00000000000E001
1111111111100000C00001
1111111111111111111111