1111111111111111111111111111111111111111
1000000000000000000000000000000000000001
10000111000000000000000000000000P0000001
1000011100000000000000000000000000000001
1000000000000000000000000000011100000001
1000000000000000000000000000011100000001
100000000000000C000000000000000000000001
1000111000000000000000000000000000000001
1000111000000000000000000000000000000001
1000000000000000000000000000000000000001
1000000000000000000000000000000000000001
1000000000000000000000000000011100000001
10000000000000E0000000000000011100000001
1000000000000000000000000000000000000001
1000000000000000000000000000000000000001
1000001110000000000000000000000C00000001
1000001110000000000000000000000000000001
1000000000000000000000001110000000000001
100000000C000000000000001110000000000001
1000000000000000000000000000000000000001
1111111111111111111111111111111111111111