11111111111111111111111111111111
10000000000000000000000000E00001
10000000000000000000000000000001
10000000000000000000000000000001
10111111000000000000000000000001
1C000000000011111100000000000001
10000000000000000000000000000001
10011000011111111111111111110C01
10000000000000000000000000000001
10000000000000000000000000000001
10000000111100111111111100000001
10000000000000000000000000000001
10011111111111100000000000000001
10C000000000000000000000000P0001
10011111111111100000000000000001
10000000000000000000000000000001
11111111111111111111111111111111