11111111111111111111
100000000000E0000001
11111000000000000001
100C0000011111111111
10000000000000000001
11111111111100000001
100000000000000C0001
10000000000000000001
10000010000010000001
10000010000010000001
100000100C0010C00001
10C00010000010000001
10000010000010000001
10000000000000000001
10000000000000000001
11111110000000000001
100000100000C0000001
10000P10000000000001
10000000000000000001
11111111111111111111