11111111111111111111
10000000000000000001
1001100000000P000001
10011000000000000001
10000000000011000001
1000C000000011000001
10000000000000000001
10000000000000000001
11111111111000000001
10000000001000000001
10000C00001000C00001
10000000001000000001
10000000001000000001
10000000001000000001
10000000001000000001
10000000000000000001
10000000000000000001
11111111111000C00001
100E0000000000000001
11111111111111111111