111111
1P0001
100E01
1C0001
100001
111111