111111111111
100000000001
1000000E0001
100000000001
111100000001
100C00000001
100000000001
100110001111
100000000001
100000000001
10000000P001
111111111111