1111111111111111111111111111111111111111111111111111111111111111111111111111111111
100000000000000000000P000000000000000000011111111111111111111111111111111110000001
11111111111111111111111111111111000000000000000000000000000000000000000C0000000001
1000000000000000000000000000000000000111111111111111100000000000000000000000000001
10000000C00001111111111100000000000000000000000000000000000000000000000C0000000001
1000000000000000001111111111111111111111111111100000000000000000000000000000000001
1111111111111000000000000000000000000000000000000000000000000C00000000000000000001
10000000000000000000C0000000000000000000000000000000000000000000000000000000000001
1000000000000000000000000000001111111111111111111111111111110000000000000000000001
11110000000000000001111110000000C0000000000000000000000000000000001111111111111111
1000000000000000000000000000000000111111111111111111100000000000000000000000000001
1000000000000000111111111111111000000000000000000C00000001111111111111111111111111
1000000000000000000000000000000000000000000000000000000000000000000000000000000001
1000000000000000000000000000000000C00000000000000000000000000C00000E00000000000001
1111111111111111111111111111111111111111111111111111111111111111111111111111111111